20,20
01,01,00,00,00,00,00,00,00,01,01,20,01,01,20,01,20,01,01,20
10,01,01,00,00,00,00,00,00,01,10,10,01,01,01,10,10,01,01,01
10,10,01,01,00,00,00,00,00,01,01,10,10,01,01,01,10,10,01,01
01,10,00,00,01,00,00,00,00,00,01,01,01,20,01,01,01,01,20,01
01,01,00,00,01,01,00,00,00,00,01,01,01,20,01,01,01,01,20,01
01,01,01,20,01,00,01,01,00,01,01,20,01,01,20,01,20,01,01,20
10,01,01,01,01,00,00,01,01,01,10,01,10,01,01,10,01,10,01,01
10,01,10,01,01,10,01,00,00,01,10,01,10,01,01,10,01,10,01,01
01,01,10,10,01,01,01,10,00,01,01,20,01,01,20,01,20,01,01,20
01,20,01,01,20,01,20,01,01,20,10,01,01,01,01,10,01,01,01,01
01,01,01,20,01,01,01,01,20,01,01,20,01,01,20,01,20,01,01,20
10,01,01,01,01,10,01,01,01,01,10,01,10,01,01,10,01,10,01,01
10,01,10,01,01,10,01,10,01,01,10,01,10,01,01,10,01,10,01,01
01,01,10,10,01,01,01,10,10,01,01,20,01,01,20,01,20,01,01,20
01,20,01,01,20,01,20,01,01,20,10,01,01,01,01,10,01,01,01,01
01,01,20,01,01,01,01,20,01,01,01,20,01,01,20,01,20,01,01,20
10,01,01,01,01,10,01,01,01,01,10,10,01,01,01,10,10,01,01,01
10,10,01,01,01,10,10,01,01,01,01,10,10,01,01,01,10,10,01,01
01,10,10,01,01,01,10,10,01,01,01,01,01,20,01,01,01,01,20,01
01,01,01,20,20,01,01,01,20,20,01,01,01,20,01,01,01,01,20,01
